恶心、呕吐	胃（脑干）、神门、交感、内分泌、食道	枕、肝、脾
急慢性胃炎	胃、交感、脾、皮质下、枕、内分泌	肺
胃神经官能症	胃、神门、肾、交感、肝	内分泌
胃溃疡	胃、神门、肾、交感、胰胆	皮质下
十二指肠溃疡	十二指肠、胃、神门、脾、交感、三焦	枕、内分泌、皮质下
胃痉挛	胃、神门、交感、耳中	枕
慢性胆囊炎	胰胆、肝、交感、内分泌、神门
慢性胰腺炎	（胰腺炎点）、内分泌、交感、神门	肾上腺
呃逆	耳中、内分泌、食道、神门
腹泻	大肠、小肠、交感、内分泌	脾、肾、肺
肠胀气	肺、大肠、小肠、胃、交感	三焦
消化不良	肠、胰胆、脾、胃、内分泌	三焦
食欲不振	胃、脾、胰胆、三焦	肝
胃肠功能紊乱	胃、交感、脾、大肠、小肠	枕、三焦
过敏性结肠炎	内分泌、大肠、交感、肺、神门、直肠	小肠、三焦
便秘	大肠、角窝中、皮质下、直肠	交感、脾、肾
酒精中毒	艇中、枕、额、皮质下
咳嗽	气管、咽喉、对屏尖、神门、肺
胸闷	交感、心、胸、肺、肾上腺
胸痛	肝、神门、相应部位、交感
伤风感冒	内鼻、外鼻、肺、肾上腺、神门
支气管炎	(支气管）、肺、角窝中、内分泌、神门、大肠	枕、耳迷根、肾
支气管哮喘	交感、肺、气管、内分泌、对屏尖、肾上腺	肾、脾、大肠
肺炎	肺区、胸、内分泌、肾上腺、交感
扁桃体炎、咽炎	扁桃体、轮4-轮4、耳尖（放血）、咽喉	耳背放血
高血压	角窝上、交感、内分泌、心、神门、肝、肾	耳背沟、相应部位
低血庄	交感、心、肾上腺、（升压点）、皮质下、相应部位
心肌炎	心、交感、神门、肾上腺
阵发性心动过速	心、交感、神门、小肠、内分泌	枕、皮质下
冠心病	心、交感、神门、内分泌、脾、皮质下	小肠、肾、（耳折痕）
心绞痛	心、交感、神门、（心脏点）、小肠
心动过缓	心、交感、肾、枕、肾上腺
心律失常	心、交感、内分泌、神门、小肠	枕
头昏、头痛	枕、额、颞、神门、皮质下、肝	肾、耳尖（放血）
失眠	神门、肾、心、枕、胃	耳尖（放血）
多梦	神门、肾、枕、心
偏头痛	颞、神门、肾、皮质下、枕
三叉神经痛	面颊区、颌、神门、肝	枕、眼
面神经麻痹	面颊区、眼、口、枕、神门、额	肝、皮质下、肾上
肋间神经痛	脑、神门、枕、交感	腺
坐骨神经痛	坐骨神经、神门、肾、肝、枕	皮质下、耳尖（放血）
脑震荡后遗症	（脑干）、肾、心、神门、额、胃
中风后遗症	皮质下、缘中、肝、相应部位	心、神门
癫痫	神门、心、枕、皮质下、胃	交感
神经衰弱	肾、心、枕、胃、垂前、神门、皮质下	肝、脾
癔症	神门、枕、心、（脑干）、皮质下、肝	相应部位
精神分裂症	肾、神门、心、（脑干）、肝	枕（枕小神经）
癔症性失语	缘中、咽喉、心、枕、肾、口	神门
面肌痉挛	面颊区、眼、口、神门、肝、脾、颞、枕	皮质下、耳尖（放血）
休克	肾上腺、心、枕、（脑干）、皮质下	升压点
膈肌痉挛	耳中、神门、交感、胃
多汗症	交感、肺、内分泌、枕、肾上腺	皮质下、内分泌
戒烟	口、肺、胃	内分泌
弱智	缘中、皮质下、心、肾、耳尖（放血）	神门、内生殖器
尿急	膀胱、肾、神门、尿道、内分泌	艇角、内分泌
尿频	交感、外生殖器、艇角、内分泌
尿潴留	肾、膀胱、交感、内分泌、输尿管	皮质下、尿道
遗尿症	膀胱、(支点)、肾、缘中	心、尿道
膀胱炎	膀胱、肾、交感、枕、肾上腺
肾盂肾炎	肾、膀胱、交感、内分泌、肝、脾	内生殖器
输尿管结石	输尿管、肾、交感、皮质下、膀胱
急性肾炎	肾、膀胱、交感、内分泌、肾上腺	输尿管
阳痿	内生殖器、外生殖器、对屏尖、内分泌、肾	腮腺、肾
睾丸炎	对屏尖、内分泌、神门、肾上腺、内生殖器
副睾丸炎	对屏尖、内分泌、神门、肾上腺、外生殖器	肾
早泄	内生殖器、对屏角、内分泌、神门	肾、心
前列腺炎	艇角、膀胱、内分泌、肾上腺、肾	三焦（神经点）
神经性多尿	肾、缘中、内分泌、神门	肺、胃、肾
糖尿病	胰胆、内分泌、三焦、神门	（饥点）、肺
肥胖症	口、食道、胃、十二指肠、内分泌（男）对屏尖
内分泌紊乱	内分泌、缘中、皮质下、肾、交感	（女）（卵巢）
脂溢性皮炎	肺、内分泌、脾、枕、肾上腺、肾	心、神门
痤疮	肺、内分泌、睾丸、面颊区
湿疹	肺、肾上腺、枕、大肠、内分泌
婴幼儿湿疹	相应都位（点刺）、肺、枕、肾上腺
口腔溃疡	口、内分泌、神门、舌、肺
牙痛	颌、神门、（牙痛点）、（喉牙）
牙周炎	颌、口、肾上腺
舌炎	舌、口、内分泌、心、肺、小肠
舌裂	舌、内分泌、交感、肺、枕、脾、小肠、肾
牙龈出血	颌、分、肾上腺、口、脾
乳腺小叶增生	内分泌、缘中、（乳腺）、枕	交感
乳腺囊肿	（乳腺）、内分泌、肾上腺、枕	神门、交感
乳腺炎	乳腺、内分泌、胸、肾上腺
急慢性阑尾炎	阑尾、大肠、交感、肺、耳迷根	内分泌
胆道蛔虫症	胆、交感、十二指肠、皮质下、耳迷根
胆结石	胆、肝、内分泌、神门、交感、耳迷根、十二指肠
内外痔	直肠、大肠、脾、肾上腺	神门、皮质下
脱肛	大肠、脾、皮质下、直肠
冻疮		脾
扭伤、压伤	相应部位、神门、肝、皮质下、枕
习惯性脱臼止痛	相应部位、肾上腺、脾、肝、神门
急性蜂窝组织炎	相应部位、肾上腺、神门、脾	耳尖（放血）
骨膜炎	相应部位、肾、神门	肾上腺、枕
晕车、晕船	肾、内耳、神门、（枕小神经）	胃
甲亢	（甲状腺）、肝、内分泌、缘中、神门、皮质下、眼、心、三焦	胃肾
痛经	内生殖器、内分泌、交感、肾、耳迷根	（卵巢）
白带过多	内生殖器、内分泌、（卵巢)、肺、交感、脾	三焦、肾
月经不调	内生殖器、内分泌、肾、交感（卵巢）
闭经	内生殖器、内分泌、肾、肝、（卵巢）、心	皮质下
附件炎	内分泌、神门、交感、肾、内生殖器	内生殖器
子宫内膜炎	内生殖器、肾、内分泌、交感、神门	肺
慢性盆腔炎	内分泌、交感、脾、盆腔、（卵巢）	神门
产后宫缩痛	内生殖器、交感、神门、皮质下、脾	肾
早泄	内生殖器、对屏尖、内分泌、神门
功能性子宫出血	内生殖器、缘中、内分泌、皮质下、肾	肾上腺
扁桃摘除后痛	扁桃体、咽喉、神门
内耳眩晕症	肾、神门、枕、内耳、皮质下	心、胃
毛囊炎	相应部位（点刺）、肺、枕、内分泌、肾上腺
带状疱疹	相应部位（点刺）、肺、内分泌、枕、肾上腺	交感
皮肤瘙痒症	门、肺、枕、内分泌、肾上腺、交感、肝	风溪、皮质下
荨麻疹	风溪、神门、肺、枕、内分泌、交感、肾上腺	相应部位
扁平疣	肺、内分泌、肾上腺、枕、相应部位点刺	大肠、皮质下
神经性皮炎	相应部位点刺、肺、交感、内分泌、肾上腺、对屏尖、枕	神门、肝
过敏性皮炎	肺、内分泌、枕、交感、肾上腺
痱子	肺、肾上腺、枕、神门
斑秃	相应部位（点刺）、肾、肺、内分泌
脱发	肾、肺、内分泌、枕
中耳炎	肾、内耳、内分泌、枕、外耳
耳鸣	肾、枕、内耳、外耳、交感	肝
听力减退	肾、枕、内耳、外耳、肾上腺
鼻出血	内鼻、肾上腺、额、肺、脾
单纯性鼻炎	内鼻、肾上腺、额、内分泌、肺
过敏性鼻炎	内鼻、肾上腺、额、内分泌、肺	风溪
声音嘶哑	咽喉、心、肺、神门、内分泌
悬雍垂水肿	咽喉、神门、肾上腺、肺、内分泌
慢性咽炎	咽喉、内分泌、肺、肾上腺
慢性咽炎	咽喉、心、内分泌、肺
急性扁桃体炎	扁桃4、咽喉、内分泌、耳尖（放血）
外阴瘙痒症	外生殖器（点刺）、神门、肺、内分泌、枕
月经过多	肾上腺、肝、脾、内生殖器	肾
泌尿不足	胸穴压痛点、（乳腺）、内分泌	脾、胃、肝
腮腺炎	腮腺、面颊区、内分泌、耳尖（灸）、皮质下	神门、肾上腺
急慢性肝炎	肝、胰胆、交感、角窝中、内分泌、胃	肝阳
麦粒肿	眼、肝、脾	肾上腺
疱疹性结合膜炎	眼、肝、肾上腺、肺耳尖放血或灸	风溪、耳背放血
夜盲	肝、屏间后、眼、枕	肾
复视	肾、肝、屏尖、眼	肾
散光	肾、肝、屏尖、枕、眼
近视眼	肾、肝、屏尖、眼、（新眼）
青光眼	肾、肝、屏尖、眼、耳尖（放血）
视神经萎缩	眼、目1、目2、肝、肾、皮质下	枕部压痛点
球后视神经炎	眼、肝、屏间后、屏间前、皮质下、额
弱视	眼、肝、屏间后、屏间前	肾
急性结合膜炎	肺、内分泌、睾丸、面颊区	肾上腺、风溪
落枕	肺、肾上腺、枕、大肠、内分泌
肩关节周围炎	相应部位（点刺）、肺、枕、肾上腺	内分泌
